Area_Name,Year,Subgroup,Victims_Above_50_Yrs,Victims_Between_10-14_Yrs,Victims_Between_14-18_Yrs,Victims_Between_18-30_Yrs,Victims_Between_30-50_Yrs,Victims_Upto_10_Yrs,Victims_of_Rape_Total
Andaman & Nicobar Islands,2001,Victims of Incest Rape,0,0,1,0,0,0,1
Andaman & Nicobar Islands,2001,Victims of Other Rape,0,0,2,0,0,0,2
Andaman & Nicobar Islands,2002,Victims of Incest Rape,0,0,0,0,0,0,0
Andaman & Nicobar Islands,2002,Victims of Other Rape,0,0,1,1,0,0,2
Andaman & Nicobar Islands,2003,Victims of Incest Rape,0,0,0,0,0,0,0
Andaman & Nicobar Islands,2003,Victims of Other Rape,0,0,1,0,0,1,2
Andaman & Nicobar Islands,2004,Victims of Incest Rape,0,0,0,0,0,0,0
Andaman & Nicobar Islands,2004,Victims of Other Rape,0,1,7,1,1,0,10
Andaman & Nicobar Islands,2005,Victims of Incest Rape,0,0,0,0,0,0,0
Andaman & Nicobar Islands,2005,Victims of Other Rape,0,0,2,2,0,0,4
Andaman & Nicobar Islands,2006,Victims of Incest Rape,0,0,0,0,0,0,0
Andaman & Nicobar Islands,2006,Victims of Other Rape,0,2,1,1,0,2,6
Andaman & Nicobar Islands,2007,Victims of Incest Rape,0,0,0,0,0,0,0
Andaman & Nicobar Islands,2007,Victims of Other Rape,0,0,3,0,0,0,3
Andaman & Nicobar Islands,2008,Victims of Incest Rape,0,0,0,0,0,0,0
Andaman & Nicobar Islands,2008,Victims of Other Rape,0,1,7,3,1,0,12
Andaman & Nicobar Islands,2009,Victims of Incest Rape,0,0,0,0,0,0,0
Andaman & Nicobar Islands,2009,Victims of Other Rape,0,3,7,5,1,2,18
Andaman & Nicobar Islands,2010,Victims of Incest Rape,0,0,0,0,0,0,0
Andaman & Nicobar Islands,2010,Victims of Other Rape,0,1,12,8,1,2,24
Andhra Pradesh,2001,Victims of Incest Rape,0,2,0,2,0,0,4
Andhra Pradesh,2001,Victims of Other Rape,14,136,254,326,80,57,867
Andhra Pradesh,2002,Victims of Incest Rape,0,2,0,3,0,0,5
Andhra Pradesh,2002,Victims of Other Rape,8,65,35,706,148,35,997
Andhra Pradesh,2003,Victims of Incest Rape,0,2,1,7,2,3,15
Andhra Pradesh,2003,Victims of Other Rape,7,133,214,422,125,30,931
Andhra Pradesh,2004,Victims of Incest Rape,0,0,3,1,0,1,5
Andhra Pradesh,2004,Victims of Other Rape,7,145,160,515,130,54,1011
Andhra Pradesh,2005,Victims of Incest Rape,0,4,0,6,6,2,18
Andhra Pradesh,2005,Victims of Other Rape,6,102,177,484,118,30,917
Andhra Pradesh,2006,Victims of Incest Rape,0,0,0,1,0,0,1
Andhra Pradesh,2006,Victims of Other Rape,10,128,238,535,91,46,1048
Andhra Pradesh,2007,Victims of Incest Rape,0,0,4,3,0,0,7
Andhra Pradesh,2007,Victims of Other Rape,7,110,197,569,128,52,1063
Andhra Pradesh,2008,Victims of Incest Rape,2,2,1,5,1,2,13
Andhra Pradesh,2008,Victims of Other Rape,9,124,236,655,173,47,1244
Andhra Pradesh,2009,Victims of Incest Rape,0,0,2,0,0,0,2
Andhra Pradesh,2009,Victims of Other Rape,14,167,206,642,116,41,1186
Andhra Pradesh,2010,Victims of Incest Rape,0,0,0,0,0,0,0
Andhra Pradesh,2010,Victims of Other Rape,15,133,283,749,152,30,1362
Arunachal Pradesh,2001,Victims of Incest Rape,0,0,0,0,0,0,0
Arunachal Pradesh,2001,Victims of Other Rape,0,0,1,28,4,0,33
Arunachal Pradesh,2002,Victims of Incest Rape,0,0,0,0,0,0,0
Arunachal Pradesh,2002,Victims of Other Rape,0,0,3,30,5,0,38
Arunachal Pradesh,2003,Victims of Incest Rape,0,0,0,0,0,0,0
Arunachal Pradesh,2003,Victims of Other Rape,0,5,4,19,0,3,31
Arunachal Pradesh,2004,Victims of Incest Rape,0,0,0,0,0,0,0
Arunachal Pradesh,2004,Victims of Other Rape,0,9,0,31,0,2,42
Arunachal Pradesh,2005,Victims of Incest Rape,0,0,0,0,0,0,0
Arunachal Pradesh,2005,Victims of Other Rape,0,5,2,25,0,3,35
Arunachal Pradesh,2006,Victims of Incest Rape,0,0,0,0,0,0,0
Arunachal Pradesh,2006,Victims of Other Rape,0,0,0,34,3,0,37
Arunachal Pradesh,2007,Victims of Incest Rape,0,0,0,0,0,0,0
Arunachal Pradesh,2007,Victims of Other Rape,0,0,0,42,5,1,48
Arunachal Pradesh,2008,Victims of Incest Rape,0,0,0,0,0,0,0
Arunachal Pradesh,2008,Victims of Other Rape,0,7,0,31,0,4,42
Arunachal Pradesh,2009,Victims of Incest Rape,0,0,0,0,0,0,0
Arunachal Pradesh,2009,Victims of Other Rape,0,12,0,42,1,4,59
Arunachal Pradesh,2010,Victims of Incest Rape,0,0,0,0,0,0,0
Arunachal Pradesh,2010,Victims of Other Rape,0,10,0,34,1,2,47
Assam,2001,Victims of Incest Rape,0,1,7,0,0,0,8
Assam,2001,Victims of Other Rape,2,72,238,370,119,8,809
Assam,2002,Victims of Incest Rape,0,0,0,5,5,0,10
Assam,2002,Victims of Other Rape,0,0,3,616,341,0,960
Assam,2003,Victims of Incest Rape,0,0,0,19,0,0,19
Assam,2003,Victims of Other Rape,3,5,0,808,260,0,1076
Assam,2004,Victims of Incest Rape,0,0,0,14,1,0,15
Assam,2004,Victims of Other Rape,14,0,0,843,292,7,1156
Assam,2005,Victims of Incest Rape,1,1,0,3,2,0,7
Assam,2005,Victims of Other Rape,14,33,37,844,284,19,1231
Assam,2006,Victims of Incest Rape,0,3,0,6,3,0,12
Assam,2006,Victims of Other Rape,2,18,32,886,286,8,1232
Assam,2007,Victims of Incest Rape,0,0,1,0,0,0,1
Assam,2007,Victims of Other Rape,14,0,39,898,485,0,1436
Assam,2008,Victims of Incest Rape,0,0,0,5,2,0,7
Assam,2008,Victims of Other Rape,21,5,20,844,539,2,1431
Assam,2009,Victims of Incest Rape,0,0,0,7,2,0,9
Assam,2009,Victims of Other Rape,14,6,3,1223,375,1,1622
Assam,2010,Victims of Incest Rape,0,0,0,10,3,0,13
Assam,2010,Victims of Other Rape,10,9,29,1106,553,1,1708
Bihar,2001,Victims of Incest Rape,0,2,5,1,0,0,8
Bihar,2001,Victims of Other Rape,0,13,193,561,112,1,880
Bihar,2002,Victims of Incest Rape,0,0,1,2,0,0,3
Bihar,2002,Victims of Other Rape,0,2,1,803,231,0,1037
Bihar,2003,Victims of Incest Rape,0,0,1,0,0,0,1
Bihar,2003,Victims of Other Rape,0,1,0,686,296,1,984
Bihar,2004,Victims of Incest Rape,0,0,0,5,1,0,6
Bihar,2004,Victims of Other Rape,6,3,0,1013,362,0,1384
Bihar,2005,Victims of Incest Rape,0,0,0,8,2,0,10
Bihar,2005,Victims of Other Rape,0,6,2,864,265,0,1137
Bihar,2006,Victims of Incest Rape,0,0,2,3,2,0,7
Bihar,2006,Victims of Other Rape,9,0,15,953,248,0,1225
Bihar,2007,Victims of Incest Rape,0,2,0,0,0,0,2
Bihar,2007,Victims of Other Rape,0,26,79,1186,253,9,1553
Bihar,2008,Victims of Incest Rape,0,0,0,1,2,0,3
Bihar,2008,Victims of Other Rape,24,11,80,1027,157,0,1299
Bihar,2009,Victims of Incest Rape,0,0,0,1,0,0,1
Bihar,2009,Victims of Other Rape,0,19,32,764,101,12,928
Bihar,2010,Victims of Incest Rape,0,1,0,0,0,1,2
Bihar,2010,Victims of Other Rape,0,16,89,616,65,7,793
Chandigarh,2001,Victims of Incest Rape,0,0,0,2,0,0,2
Chandigarh,2001,Victims of Other Rape,0,8,4,2,3,0,17
Chandigarh,2002,Victims of Incest Rape,0,0,1,1,0,0,2
Chandigarh,2002,Victims of Other Rape,0,4,0,8,3,1,16
Chandigarh,2003,Victims of Incest Rape,0,0,0,0,0,1,1
Chandigarh,2003,Victims of Other Rape,0,1,5,7,2,2,17
Chandigarh,2004,Victims of Incest Rape,0,1,0,0,0,0,1
Chandigarh,2004,Victims of Other Rape,0,4,3,5,1,5,18
Chandigarh,2005,Victims of Incest Rape,0,0,1,0,0,0,1
Chandigarh,2005,Victims of Other Rape,0,4,9,5,7,7,32
Chandigarh,2006,Victims of Incest Rape,0,1,2,1,0,1,5
Chandigarh,2006,Victims of Other Rape,0,1,4,3,4,2,14
Chandigarh,2007,Victims of Incest Rape,0,1,0,0,0,1,2
Chandigarh,2007,Victims of Other Rape,0,2,2,11,3,2,20
Chandigarh,2008,Victims of Incest Rape,0,0,2,1,0,0,3
Chandigarh,2008,Victims of Other Rape,0,3,5,6,1,2,17
Chandigarh,2009,Victims of Incest Rape,0,0,0,0,0,0,0
Chandigarh,2009,Victims of Other Rape,0,8,10,8,0,3,29
Chandigarh,2010,Victims of Incest Rape,0,0,0,0,0,0,0
Chandigarh,2010,Victims of Other Rape,0,8,4,15,0,4,31
Chhattisgarh,2001,Victims of Incest Rape,0,3,1,1,1,0,6
Chhattisgarh,2001,Victims of Other Rape,4,188,217,383,136,25,953
Chhattisgarh,2002,Victims of Incest Rape,3,13,18,16,11,2,63
Chhattisgarh,2002,Victims of Other Rape,8,118,7,636,136,24,929
Chhattisgarh,2003,Victims of Incest Rape,0,2,16,13,7,1,39
Chhattisgarh,2003,Victims of Other Rape,5,95,46,363,324,26,859
Chhattisgarh,2004,Victims of Incest Rape,1,6,30,30,9,2,78
Chhattisgarh,2004,Victims of Other Rape,8,55,203,396,217,12,891
Chhattisgarh,2005,Victims of Incest Rape,0,10,33,39,27,1,110
Chhattisgarh,2005,Victims of Other Rape,16,102,222,353,173,14,880
Chhattisgarh,2006,Victims of Incest Rape,2,12,33,29,15,6,97
Chhattisgarh,2006,Victims of Other Rape,25,92,283,308,168,22,898
Chhattisgarh,2007,Victims of Incest Rape,0,10,31,14,6,2,63
Chhattisgarh,2007,Victims of Other Rape,13,107,188,486,95,30,919
Chhattisgarh,2008,Victims of Incest Rape,0,3,15,12,1,0,31
Chhattisgarh,2008,Victims of Other Rape,3,77,292,376,175,24,947
Chhattisgarh,2009,Victims of Incest Rape,2,2,8,6,5,1,24
Chhattisgarh,2009,Victims of Other Rape,7,225,79,454,108,79,952
Chhattisgarh,2010,Victims of Incest Rape,0,2,3,13,3,0,21
Chhattisgarh,2010,Victims of Other Rape,16,85,268,411,187,24,991
Dadra & Nagar Haveli,2001,Victims of Incest Rape,0,0,0,0,0,0,0
Dadra & Nagar Haveli,2001,Victims of Other Rape,0,0,3,3,0,0,6
Dadra & Nagar Haveli,2002,Victims of Incest Rape,0,0,0,0,0,0,0
Dadra & Nagar Haveli,2002,Victims of Other Rape,0,1,1,1,0,1,4
Dadra & Nagar Haveli,2003,Victims of Incest Rape,0,0,0,0,0,0,0
Dadra & Nagar Haveli,2003,Victims of Other Rape,0,0,0,1,0,0,1
Dadra & Nagar Haveli,2004,Victims of Incest Rape,0,0,0,0,0,0,0
Dadra & Nagar Haveli,2004,Victims of Other Rape,0,0,0,6,1,0,7
Dadra & Nagar Haveli,2005,Victims of Incest Rape,0,0,0,0,0,0,0
Dadra & Nagar Haveli,2005,Victims of Other Rape,0,0,0,5,0,0,5
Dadra & Nagar Haveli,2006,Victims of Incest Rape,0,0,0,0,0,0,0
Dadra & Nagar Haveli,2006,Victims of Other Rape,0,1,2,1,0,2,6
Dadra & Nagar Haveli,2007,Victims of Incest Rape,0,0,0,0,0,0,0
Dadra & Nagar Haveli,2007,Victims of Other Rape,0,2,4,0,0,1,7
Dadra & Nagar Haveli,2008,Victims of Incest Rape,0,0,0,0,0,0,0
Dadra & Nagar Haveli,2008,Victims of Other Rape,0,1,2,3,0,0,6
Dadra & Nagar Haveli,2009,Victims of Incest Rape,0,0,0,0,0,0,0
Dadra & Nagar Haveli,2009,Victims of Other Rape,0,2,0,2,0,0,4
Dadra & Nagar Haveli,2010,Victims of Incest Rape,0,0,0,0,0,0,0
Dadra & Nagar Haveli,2010,Victims of Other Rape,0,1,1,0,0,1,3
Daman & Diu,2001,Victims of Incest Rape,0,0,0,0,0,0,0
Daman & Diu,2001,Victims of Other Rape,0,0,0,0,0,0,0
Daman & Diu,2002,Victims of Incest Rape,0,0,0,0,0,0,0
Daman & Diu,2002,Victims of Other Rape,0,0,0,0,0,0,0
Daman & Diu,2003,Victims of Incest Rape,0,0,0,0,0,0,0
Daman & Diu,2003,Victims of Other Rape,0,0,3,0,0,2,5
Daman & Diu,2004,Victims of Incest Rape,0,0,0,0,0,0,0
Daman & Diu,2004,Victims of Other Rape,0,0,1,0,0,0,1
Daman & Diu,2005,Victims of Incest Rape,0,0,0,0,0,0,0
Daman & Diu,2005,Victims of Other Rape,0,1,0,0,1,0,2
Daman & Diu,2006,Victims of Incest Rape,0,0,0,0,0,0,0
Daman & Diu,2006,Victims of Other Rape,0,0,0,2,0,1,3
Daman & Diu,2007,Victims of Incest Rape,0,0,0,0,0,0,0
Daman & Diu,2007,Victims of Other Rape,0,0,0,1,0,0,1
Daman & Diu,2008,Victims of Incest Rape,0,0,0,0,0,0,0
Daman & Diu,2008,Victims of Other Rape,0,0,0,0,0,0,0
Daman & Diu,2009,Victims of Incest Rape,0,0,0,0,0,0,0
Daman & Diu,2009,Victims of Other Rape,0,0,0,0,0,1,1
Daman & Diu,2010,Victims of Incest Rape,0,0,0,0,0,0,0
Daman & Diu,2010,Victims of Other Rape,0,0,0,0,0,1,1
Delhi,2001,Victims of Incest Rape,0,3,2,1,0,3,9
Delhi,2001,Victims of Other Rape,0,78,152,58,41,45,374
Delhi,2002,Victims of Incest Rape,0,6,12,10,0,4,32
Delhi,2002,Victims of Other Rape,0,48,40,207,49,31,375
Delhi,2003,Victims of Incest Rape,0,5,11,4,0,1,21
Delhi,2003,Victims of Other Rape,0,45,65,317,17,25,469
Delhi,2004,Victims of Incest Rape,0,7,6,2,0,1,16
Delhi,2004,Victims of Other Rape,0,119,71,280,6,59,535
Delhi,2005,Victims of Incest Rape,0,9,10,2,0,11,32
Delhi,2005,Victims of Other Rape,2,111,45,402,25,49,634
Delhi,2006,Victims of Incest Rape,0,4,12,7,0,3,26
Delhi,2006,Victims of Other Rape,2,107,255,148,21,67,600
Delhi,2007,Victims of Incest Rape,0,2,9,5,0,2,18
Delhi,2007,Victims of Other Rape,1,92,219,174,24,74,584
Delhi,2008,Victims of Incest Rape,4,12,8,10,1,2,37
Delhi,2008,Victims of Other Rape,2,83,127,123,29,69,433
Delhi,2009,Victims of Incest Rape,0,3,5,6,2,3,19
Delhi,2009,Victims of Other Rape,1,69,183,135,18,44,450
Delhi,2010,Victims of Incest Rape,0,11,3,1,0,6,21
Delhi,2010,Victims of Other Rape,1,68,171,167,34,45,486
Goa,2001,Victims of Incest Rape,0,0,0,0,0,0,0
Goa,2001,Victims of Other Rape,0,7,1,0,1,3,12
Goa,2002,Victims of Incest Rape,0,0,0,0,0,0,0
Goa,2002,Victims of Other Rape,0,3,3,4,1,1,12
Goa,2003,Victims of Incest Rape,0,0,0,0,0,0,0
Goa,2003,Victims of Other Rape,0,9,8,7,2,6,32
Goa,2004,Victims of Incest Rape,0,0,1,0,0,0,1
Goa,2004,Victims of Other Rape,0,7,4,12,5,8,36
Goa,2005,Victims of Incest Rape,0,0,0,0,0,1,1
Goa,2005,Victims of Other Rape,0,4,7,4,1,3,19
Goa,2006,Victims of Incest Rape,0,0,0,1,0,0,1
Goa,2006,Victims of Other Rape,1,4,9,4,1,1,20
Goa,2007,Victims of Incest Rape,0,0,1,0,0,0,1
Goa,2007,Victims of Other Rape,0,4,6,4,1,4,19
Goa,2008,Victims of Incest Rape,0,0,0,0,0,0,0
Goa,2008,Victims of Other Rape,2,6,11,7,3,1,30
Goa,2009,Victims of Incest Rape,0,0,1,0,0,0,1
Goa,2009,Victims of Other Rape,0,11,20,15,2,1,49
Goa,2010,Victims of Incest Rape,0,0,2,0,0,0,2
Goa,2010,Victims of Other Rape,2,5,12,11,0,4,34
Gujarat,2001,Victims of Incest Rape,0,0,2,0,0,0,2
Gujarat,2001,Victims of Other Rape,0,23,85,125,36,15,284
Gujarat,2002,Victims of Incest Rape,0,4,2,2,0,2,10
Gujarat,2002,Victims of Other Rape,0,12,41,174,17,14,258
Gujarat,2003,Victims of Incest Rape,0,0,3,3,0,1,7
Gujarat,2003,Victims of Other Rape,0,17,43,140,13,16,229
Gujarat,2004,Victims of Incest Rape,0,2,2,7,3,0,14
Gujarat,2004,Victims of Other Rape,2,25,55,187,44,12,325
Gujarat,2005,Victims of Incest Rape,0,4,5,8,0,2,19
Gujarat,2005,Victims of Other Rape,0,24,39,210,16,16,305
Gujarat,2006,Victims of Incest Rape,0,2,0,14,0,0,16
Gujarat,2006,Victims of Other Rape,1,28,62,199,28,20,338
Gujarat,2007,Victims of Incest Rape,0,0,1,0,1,1,3
Gujarat,2007,Victims of Other Rape,1,30,50,180,36,17,314
Gujarat,2008,Victims of Incest Rape,0,1,2,1,0,0,4
Gujarat,2008,Victims of Other Rape,1,26,55,216,57,15,370
Gujarat,2009,Victims of Incest Rape,0,2,3,10,2,1,18
Gujarat,2009,Victims of Other Rape,1,25,47,298,30,14,415
Gujarat,2010,Victims of Incest Rape,0,0,2,1,0,1,4
Gujarat,2010,Victims of Other Rape,2,28,51,260,42,21,404
Haryana,2001,Victims of Incest Rape,0,0,0,0,0,0,0
Haryana,2001,Victims of Other Rape,3,62,125,134,40,34,398
Haryana,2002,Victims of Incest Rape,0,6,3,39,4,0,52
Haryana,2002,Victims of Other Rape,1,43,3,198,35,29,309
Haryana,2003,Victims of Incest Rape,0,0,3,11,0,0,14
Haryana,2003,Victims of Other Rape,0,5,67,237,28,2,339
Haryana,2004,Victims of Incest Rape,0,0,3,13,4,0,20
Haryana,2004,Victims of Other Rape,0,2,17,302,43,2,366
Haryana,2005,Victims of Incest Rape,0,0,3,10,2,0,15
Haryana,2005,Victims of Other Rape,6,34,94,171,141,0,446
Haryana,2006,Victims of Incest Rape,0,0,0,8,2,0,10
Haryana,2006,Victims of Other Rape,5,22,153,368,49,1,598
Haryana,2007,Victims of Incest Rape,0,2,0,1,0,0,3
Haryana,2007,Victims of Other Rape,3,24,79,321,41,17,485
Haryana,2008,Victims of Incest Rape,1,1,2,4,0,0,8
Haryana,2008,Victims of Other Rape,4,21,36,491,61,10,623
Haryana,2009,Victims of Incest Rape,0,2,0,7,1,2,12
Haryana,2009,Victims of Other Rape,3,25,70,423,53,17,591
Haryana,2010,Victims of Incest Rape,0,1,1,11,2,0,15
Haryana,2010,Victims of Other Rape,5,22,79,470,125,4,705
Himachal Pradesh,2001,Victims of Incest Rape,0,0,0,0,0,0,0
Himachal Pradesh,2001,Victims of Other Rape,2,15,43,35,9,20,124
Himachal Pradesh,2002,Victims of Incest Rape,0,1,0,0,0,0,1
Himachal Pradesh,2002,Victims of Other Rape,4,4,16,71,36,5,136
Himachal Pradesh,2003,Victims of Incest Rape,0,0,1,1,0,0,2
Himachal Pradesh,2003,Victims of Other Rape,0,14,24,55,23,8,124
Himachal Pradesh,2004,Victims of Incest Rape,0,2,1,3,2,0,8
Himachal Pradesh,2004,Victims of Other Rape,5,9,16,65,46,4,145
Himachal Pradesh,2005,Victims of Incest Rape,0,1,2,2,0,0,5
Himachal Pradesh,2005,Victims of Other Rape,2,16,28,61,18,11,136
Himachal Pradesh,2006,Victims of Incest Rape,0,2,1,2,0,2,7
Himachal Pradesh,2006,Victims of Other Rape,1,7,26,64,4,4,106
Himachal Pradesh,2007,Victims of Incest Rape,0,0,0,0,1,1,2
Himachal Pradesh,2007,Victims of Other Rape,2,19,46,58,22,10,157
Himachal Pradesh,2008,Victims of Incest Rape,0,1,0,0,0,0,1
Himachal Pradesh,2008,Victims of Other Rape,1,15,44,68,20,8,156
Himachal Pradesh,2009,Victims of Incest Rape,0,2,5,1,1,1,10
Himachal Pradesh,2009,Victims of Other Rape,0,14,50,83,15,11,173
Himachal Pradesh,2010,Victims of Incest Rape,1,3,2,1,0,0,7
Himachal Pradesh,2010,Victims of Other Rape,0,13,46,66,20,8,153
Jammu & Kashmir,2001,Victims of Incest Rape,0,0,1,1,0,0,2
Jammu & Kashmir,2001,Victims of Other Rape,0,24,40,83,20,0,167
Jammu & Kashmir,2002,Victims of Incest Rape,0,0,0,3,0,0,3
Jammu & Kashmir,2002,Victims of Other Rape,1,0,7,137,44,0,189
Jammu & Kashmir,2003,Victims of Incest Rape,0,0,0,2,0,0,2
Jammu & Kashmir,2003,Victims of Other Rape,0,1,0,145,62,1,209
Jammu & Kashmir,2004,Victims of Incest Rape,0,0,0,1,0,0,1
Jammu & Kashmir,2004,Victims of Other Rape,0,0,2,169,44,2,217
Jammu & Kashmir,2005,Victims of Incest Rape,0,0,0,0,0,0,0
Jammu & Kashmir,2005,Victims of Other Rape,2,0,3,153,42,1,201
Jammu & Kashmir,2006,Victims of Incest Rape,0,0,0,0,0,0,0
Jammu & Kashmir,2006,Victims of Other Rape,1,8,0,193,48,0,250
Jammu & Kashmir,2007,Victims of Incest Rape,0,0,0,0,0,0,0
Jammu & Kashmir,2007,Victims of Other Rape,0,5,10,176,97,0,288
Jammu & Kashmir,2008,Victims of Incest Rape,0,0,0,0,0,0,0
Jammu & Kashmir,2008,Victims of Other Rape,0,0,3,155,59,2,219
Jammu & Kashmir,2009,Victims of Incest Rape,0,1,0,2,1,0,4
Jammu & Kashmir,2009,Victims of Other Rape,2,0,3,175,51,0,231
Jammu & Kashmir,2010,Victims of Incest Rape,0,0,0,0,0,0,0
Jammu & Kashmir,2010,Victims of Other Rape,0,1,7,187,50,0,245
Jharkhand,2001,Victims of Incest Rape,0,3,4,2,2,1,12
Jharkhand,2001,Victims of Other Rape,0,0,0,476,71,8,555
Jharkhand,2002,Victims of Incest Rape,0,0,4,11,3,0,18
Jharkhand,2002,Victims of Other Rape,0,0,39,665,75,0,779
Jharkhand,2003,Victims of Incest Rape,0,2,6,6,0,0,14
Jharkhand,2003,Victims of Other Rape,0,4,4,600,90,0,698
Jharkhand,2004,Victims of Incest Rape,0,0,4,11,3,0,18
Jharkhand,2004,Victims of Other Rape,0,0,39,665,75,0,779
Jharkhand,2005,Victims of Incest Rape,0,4,8,65,41,2,120
Jharkhand,2005,Victims of Other Rape,1,3,4,319,302,4,633
Jharkhand,2006,Victims of Incest Rape,0,6,21,50,17,0,94
Jharkhand,2006,Victims of Other Rape,2,39,177,369,116,2,705
Jharkhand,2007,Victims of Incest Rape,0,0,0,0,0,0,0
Jharkhand,2007,Victims of Other Rape,5,15,8,639,188,0,855
Jharkhand,2008,Victims of Incest Rape,0,0,0,7,5,0,12
Jharkhand,2008,Victims of Other Rape,2,2,5,655,114,1,779
Jharkhand,2009,Victims of Incest Rape,0,0,0,16,6,0,22
Jharkhand,2009,Victims of Other Rape,0,0,5,478,210,4,697
Jharkhand,2010,Victims of Incest Rape,0,0,0,10,1,0,11
Jharkhand,2010,Victims of Other Rape,0,0,0,594,168,0,762
Karnataka,2001,Victims of Incest Rape,0,0,1,1,0,3,5
Karnataka,2001,Victims of Other Rape,0,63,61,122,21,21,288
Karnataka,2002,Victims of Incest Rape,0,1,0,3,0,0,4
Karnataka,2002,Victims of Other Rape,1,9,6,215,54,3,288
Karnataka,2003,Victims of Incest Rape,0,0,0,0,0,1,1
Karnataka,2003,Victims of Other Rape,16,47,67,135,38,17,320
Karnataka,2004,Victims of Incest Rape,0,1,0,4,0,2,7
Karnataka,2004,Victims of Other Rape,0,14,12,197,48,13,284
Karnataka,2005,Victims of Incest Rape,0,0,0,3,2,0,5
Karnataka,2005,Victims of Other Rape,0,13,21,231,59,14,338
Karnataka,2006,Victims of Incest Rape,0,1,0,1,0,0,2
Karnataka,2006,Victims of Other Rape,2,15,46,267,45,23,398
Karnataka,2007,Victims of Incest Rape,0,0,1,1,0,0,2
Karnataka,2007,Victims of Other Rape,7,32,31,296,48,20,434
Karnataka,2008,Victims of Incest Rape,0,0,0,0,0,0,0
Karnataka,2008,Victims of Other Rape,1,24,52,301,47,21,446
Karnataka,2009,Victims of Incest Rape,0,0,0,17,1,0,18
Karnataka,2009,Victims of Other Rape,4,49,18,344,37,39,491
Karnataka,2010,Victims of Incest Rape,0,0,0,2,0,0,2
Karnataka,2010,Victims of Other Rape,3,47,69,367,88,10,584
Kerala,2001,Victims of Incest Rape,1,0,1,1,0,1,4
Kerala,2001,Victims of Other Rape,0,46,125,305,64,18,558
Kerala,2002,Victims of Incest Rape,0,1,0,3,0,0,4
Kerala,2002,Victims of Other Rape,3,28,132,262,45,25,495
Kerala,2003,Victims of Incest Rape,0,3,0,3,0,1,7
Kerala,2003,Victims of Other Rape,2,33,13,264,56,19,387
Kerala,2004,Victims of Incest Rape,0,0,2,1,0,0,3
Kerala,2004,Victims of Other Rape,6,36,102,257,57,19,477
Kerala,2005,Victims of Incest Rape,1,1,4,5,0,1,12
Kerala,2005,Victims of Other Rape,7,30,82,231,90,29,469
Kerala,2006,Victims of Incest Rape,1,3,9,8,3,4,28
Kerala,2006,Victims of Other Rape,6,56,118,273,93,31,577
Kerala,2007,Victims of Incest Rape,0,5,4,11,0,1,21
Kerala,2007,Victims of Other Rape,5,40,111,251,63,22,492
Kerala,2008,Victims of Incest Rape,0,6,6,4,1,0,17
Kerala,2008,Victims of Other Rape,6,45,133,270,72,27,553
Kerala,2009,Victims of Incest Rape,0,3,7,4,1,3,18
Kerala,2009,Victims of Other Rape,10,42,150,249,69,30,550
Kerala,2010,Victims of Incest Rape,0,5,2,2,0,5,14
Kerala,2010,Victims of Other Rape,12,43,131,326,86,24,622
Lakshadweep,2001,Victims of Incest Rape,0,0,0,0,0,0,0
Lakshadweep,2001,Victims of Other Rape,0,0,0,0,0,0,0
Lakshadweep,2002,Victims of Incest Rape,0,0,0,0,0,0,0
Lakshadweep,2002,Victims of Other Rape,0,0,0,0,1,0,1
Lakshadweep,2003,Victims of Incest Rape,0,0,0,0,0,0,0
Lakshadweep,2003,Victims of Other Rape,0,0,0,2,0,0,2
Lakshadweep,2004,Victims of Incest Rape,0,0,0,0,0,0,0
Lakshadweep,2004,Victims of Other Rape,0,0,0,0,0,0,0
Lakshadweep,2005,Victims of Incest Rape,0,0,0,0,0,0,0
Lakshadweep,2005,Victims of Other Rape,0,0,0,0,0,0,0
Lakshadweep,2006,Victims of Incest Rape,0,0,0,0,0,0,0
Lakshadweep,2006,Victims of Other Rape,0,0,0,0,0,0,0
Lakshadweep,2007,Victims of Incest Rape,0,0,0,0,0,0,0
Lakshadweep,2007,Victims of Other Rape,0,0,0,1,0,0,1
Lakshadweep,2008,Victims of Incest Rape,0,0,0,0,0,0,0
Lakshadweep,2008,Victims of Other Rape,0,0,0,1,1,0,2
Lakshadweep,2009,Victims of Incest Rape,0,0,0,0,0,0,0
Lakshadweep,2009,Victims of Other Rape,0,0,0,1,0,0,1
Lakshadweep,2010,Victims of Incest Rape,0,0,0,0,0,0,0
Lakshadweep,2010,Victims of Other Rape,0,0,0,0,0,0,0
Madhya Pradesh,2001,Victims of Incest Rape,0,39,66,130,56,10,301
Madhya Pradesh,2001,Victims of Other Rape,27,265,491,1120,571,76,2550
Madhya Pradesh,2002,Victims of Incest Rape,1,11,16,37,4,3,72
Madhya Pradesh,2002,Victims of Other Rape,13,174,236,1512,807,77,2819
Madhya Pradesh,2003,Victims of Incest Rape,0,10,23,71,16,3,123
Madhya Pradesh,2003,Victims of Other Rape,7,221,382,1475,470,60,2615
Madhya Pradesh,2004,Victims of Incest Rape,0,5,24,24,7,3,63
Madhya Pradesh,2004,Victims of Other Rape,14,275,314,1649,471,89,2812
Madhya Pradesh,2005,Victims of Incest Rape,1,18,43,57,13,9,141
Madhya Pradesh,2005,Victims of Other Rape,25,276,431,1339,616,93,2780
Madhya Pradesh,2006,Victims of Incest Rape,0,5,5,12,4,3,29
Madhya Pradesh,2006,Victims of Other Rape,7,91,705,1390,658,20,2871
Madhya Pradesh,2007,Victims of Incest Rape,0,7,23,14,4,1,49
Madhya Pradesh,2007,Victims of Other Rape,43,280,669,1385,521,63,2961
Madhya Pradesh,2008,Victims of Incest Rape,0,9,20,15,5,3,52
Madhya Pradesh,2008,Victims of Other Rape,20,218,576,1533,472,66,2885
Madhya Pradesh,2009,Victims of Incest Rape,0,1,9,2,1,1,14
Madhya Pradesh,2009,Victims of Other Rape,11,290,695,1403,510,75,2984
Madhya Pradesh,2010,Victims of Incest Rape,0,1,10,4,4,2,21
Madhya Pradesh,2010,Victims of Other Rape,12,303,816,1360,573,51,3115
Maharashtra,2001,Victims of Incest Rape,0,5,6,4,4,1,20
Maharashtra,2001,Victims of Other Rape,4,147,413,499,131,88,1282
Maharashtra,2002,Victims of Incest Rape,0,3,5,9,4,0,21
Maharashtra,2002,Victims of Other Rape,7,127,314,684,136,63,1331
Maharashtra,2003,Victims of Incest Rape,0,1,6,8,0,4,19
Maharashtra,2003,Victims of Other Rape,4,115,411,533,119,75,1257
Maharashtra,2004,Victims of Incest Rape,0,5,15,8,1,3,32
Maharashtra,2004,Victims of Other Rape,5,128,404,619,122,82,1360
Maharashtra,2005,Victims of Incest Rape,0,5,13,14,3,3,38
Maharashtra,2005,Victims of Other Rape,2,127,408,721,171,82,1511
Maharashtra,2006,Victims of Incest Rape,0,9,11,8,4,4,36
Maharashtra,2006,Victims of Other Rape,4,118,434,699,136,79,1470
Maharashtra,2007,Victims of Incest Rape,0,5,9,13,9,4,40
Maharashtra,2007,Victims of Other Rape,13,120,384,646,159,95,1417
Maharashtra,2008,Victims of Incest Rape,1,5,8,11,6,4,35
Maharashtra,2008,Victims of Other Rape,4,130,433,696,155,114,1532
Maharashtra,2009,Victims of Incest Rape,0,3,19,47,3,5,77
Maharashtra,2009,Victims of Other Rape,8,118,344,666,154,126,1416
Maharashtra,2010,Victims of Incest Rape,0,8,13,18,1,4,44
Maharashtra,2010,Victims of Other Rape,11,126,502,657,167,104,1567
Manipur,2001,Victims of Incest Rape,0,0,0,0,0,2,2
Manipur,2001,Victims of Other Rape,1,1,4,9,2,1,18
Manipur,2002,Victims of Incest Rape,0,0,0,3,0,0,3
Manipur,2002,Victims of Other Rape,0,0,0,11,0,0,11
Manipur,2003,Victims of Incest Rape,0,0,0,0,0,0,0
Manipur,2003,Victims of Other Rape,1,0,7,10,0,0,18
Manipur,2004,Victims of Incest Rape,0,0,0,0,0,0,0
Manipur,2004,Victims of Other Rape,0,0,2,20,5,4,31
Manipur,2005,Victims of Incest Rape,0,0,0,0,1,0,1
Manipur,2005,Victims of Other Rape,0,1,0,14,6,3,24
Manipur,2006,Victims of Incest Rape,0,0,0,0,0,0,0
Manipur,2006,Victims of Other Rape,0,4,9,17,6,6,42
Manipur,2007,Victims of Incest Rape,0,0,0,0,0,1,1
Manipur,2007,Victims of Other Rape,0,2,0,14,2,1,19
Manipur,2008,Victims of Incest Rape,0,0,0,0,0,0,0
Manipur,2008,Victims of Other Rape,0,8,8,12,1,9,38
Manipur,2009,Victims of Incest Rape,0,0,0,0,0,0,0
Manipur,2009,Victims of Other Rape,1,5,2,9,9,5,31
Manipur,2010,Victims of Incest Rape,0,0,0,0,0,0,0
Manipur,2010,Victims of Other Rape,0,2,8,20,3,1,34
Meghalaya,2001,Victims of Incest Rape,0,0,1,1,2,1,5
Meghalaya,2001,Victims of Other Rape,0,2,3,13,1,2,21
Meghalaya,2002,Victims of Incest Rape,0,0,0,0,0,1,1
Meghalaya,2002,Victims of Other Rape,0,9,22,4,0,2,37
Meghalaya,2003,Victims of Incest Rape,0,2,1,1,0,1,5
Meghalaya,2003,Victims of Other Rape,1,3,14,13,1,3,35
Meghalaya,2004,Victims of Incest Rape,0,3,0,1,0,0,4
Meghalaya,2004,Victims of Other Rape,0,5,9,33,0,3,50
Meghalaya,2005,Victims of Incest Rape,0,0,3,0,0,1,4
Meghalaya,2005,Victims of Other Rape,0,10,29,8,4,8,59
Meghalaya,2006,Victims of Incest Rape,0,0,0,0,0,0,0
Meghalaya,2006,Victims of Other Rape,0,11,23,23,3,14,74
Meghalaya,2007,Victims of Incest Rape,0,0,1,6,0,2,9
Meghalaya,2007,Victims of Other Rape,0,12,18,30,2,22,84
Meghalaya,2008,Victims of Incest Rape,0,3,0,1,0,1,5
Meghalaya,2008,Victims of Other Rape,0,14,14,46,4,5,83
Meghalaya,2009,Victims of Incest Rape,0,2,1,1,0,1,5
Meghalaya,2009,Victims of Other Rape,3,21,18,40,7,18,107
Meghalaya,2010,Victims of Incest Rape,0,4,1,1,0,2,8
Meghalaya,2010,Victims of Other Rape,0,30,25,40,17,31,143
Mizoram,2001,Victims of Incest Rape,0,0,0,0,0,0,0
Mizoram,2001,Victims of Other Rape,0,0,30,14,8,0,52
Mizoram,2002,Victims of Incest Rape,0,0,0,0,0,0,0
Mizoram,2002,Victims of Other Rape,9,1,1,52,13,0,76
Mizoram,2003,Victims of Incest Rape,0,1,1,0,0,0,2
Mizoram,2003,Victims of Other Rape,0,2,5,22,22,1,52
Mizoram,2004,Victims of Incest Rape,0,0,0,0,0,0,0
Mizoram,2004,Victims of Other Rape,0,0,0,12,8,0,20
Mizoram,2005,Victims of Incest Rape,0,0,0,0,0,0,0
Mizoram,2005,Victims of Other Rape,0,0,30,7,0,0,37
Mizoram,2006,Victims of Incest Rape,0,0,0,0,0,0,0
Mizoram,2006,Victims of Other Rape,0,19,9,32,5,7,72
Mizoram,2007,Victims of Incest Rape,1,0,0,0,0,1,2
Mizoram,2007,Victims of Other Rape,1,23,18,10,7,22,81
Mizoram,2008,Victims of Incest Rape,0,1,1,1,0,0,3
Mizoram,2008,Victims of Other Rape,0,3,4,48,10,9,74
Mizoram,2009,Victims of Incest Rape,0,1,0,0,0,2,3
Mizoram,2009,Victims of Other Rape,0,2,3,42,30,3,80
Mizoram,2010,Victims of Incest Rape,0,0,1,0,0,2,3
Mizoram,2010,Victims of Other Rape,4,17,14,29,17,8,89
Nagaland,2001,Victims of Incest Rape,0,0,0,0,1,0,1
Nagaland,2001,Victims of Other Rape,0,0,8,6,2,0,16
Nagaland,2002,Victims of Incest Rape,0,0,0,0,0,0,0
Nagaland,2002,Victims of Other Rape,0,1,3,11,0,2,17
Nagaland,2003,Victims of Incest Rape,0,0,0,0,0,0,0
Nagaland,2003,Victims of Other Rape,0,0,0,14,0,0,14
Nagaland,2004,Victims of Incest Rape,0,0,0,0,0,0,0
Nagaland,2004,Victims of Other Rape,0,0,0,17,0,1,18
Nagaland,2005,Victims of Incest Rape,0,0,0,0,0,0,0
Nagaland,2005,Victims of Other Rape,0,0,0,12,2,3,17
Nagaland,2006,Victims of Incest Rape,0,0,0,0,0,0,0
Nagaland,2006,Victims of Other Rape,0,1,4,11,1,6,23
Nagaland,2007,Victims of Incest Rape,0,0,1,0,0,0,1
Nagaland,2007,Victims of Other Rape,0,0,2,6,4,0,12
Nagaland,2008,Victims of Incest Rape,0,0,0,1,0,0,1
Nagaland,2008,Victims of Other Rape,0,0,0,18,0,0,18
Nagaland,2009,Victims of Incest Rape,0,0,0,0,0,0,0
Nagaland,2009,Victims of Other Rape,0,0,0,17,5,0,22
Nagaland,2010,Victims of Incest Rape,0,0,1,0,0,0,1
Nagaland,2010,Victims of Other Rape,0,1,1,6,6,1,15
Odisha,2001,Victims of Incest Rape,0,0,3,1,0,0,4
Odisha,2001,Victims of Other Rape,0,9,294,401,74,8,786
Odisha,2002,Victims of Incest Rape,0,1,0,0,0,0,1
Odisha,2002,Victims of Other Rape,0,8,0,614,56,12,690
Odisha,2003,Victims of Incest Rape,0,0,0,0,0,0,0
Odisha,2003,Victims of Other Rape,1,18,32,586,83,5,725
Odisha,2004,Victims of Incest Rape,0,1,0,0,0,0,1
Odisha,2004,Victims of Other Rape,0,1,2,616,123,27,769
Odisha,2005,Victims of Incest Rape,0,0,0,6,1,0,7
Odisha,2005,Victims of Other Rape,3,0,10,630,131,18,792
Odisha,2006,Victims of Incest Rape,0,0,0,0,0,0,0
Odisha,2006,Victims of Other Rape,2,51,27,730,152,23,985
Odisha,2007,Victims of Incest Rape,0,0,0,0,0,0,0
Odisha,2007,Victims of Other Rape,0,41,42,659,188,9,939
Odisha,2008,Victims of Incest Rape,0,0,1,13,1,2,17
Odisha,2008,Victims of Other Rape,12,27,23,632,387,15,1096
Odisha,2009,Victims of Incest Rape,0,1,0,5,0,0,6
Odisha,2009,Victims of Other Rape,7,23,57,742,182,6,1017
Odisha,2010,Victims of Incest Rape,0,12,21,2,0,2,37
Odisha,2010,Victims of Other Rape,5,5,23,785,159,11,988
Puducherry,2001,Victims of Incest Rape,0,0,0,0,0,0,0
Puducherry,2001,Victims of Other Rape,0,2,2,1,1,3,9
Puducherry,2002,Victims of Incest Rape,0,0,0,0,0,0,0
Puducherry,2002,Victims of Other Rape,0,0,3,2,0,1,6
Puducherry,2003,Victims of Incest Rape,0,0,0,0,0,0,0
Puducherry,2003,Victims of Other Rape,0,0,0,1,0,1,2
Puducherry,2004,Victims of Incest Rape,0,0,0,0,0,0,0
Puducherry,2004,Victims of Other Rape,0,0,4,0,0,0,4
Puducherry,2005,Victims of Incest Rape,0,0,0,0,0,0,0
Puducherry,2005,Victims of Other Rape,0,0,2,3,0,1,6
Puducherry,2006,Victims of Incest Rape,0,0,0,0,0,0,0
Puducherry,2006,Victims of Other Rape,0,1,5,1,0,2,9
Puducherry,2007,Victims of Incest Rape,0,0,0,0,0,0,0
Puducherry,2007,Victims of Other Rape,0,0,2,6,0,1,9
Puducherry,2008,Victims of Incest Rape,0,0,0,0,0,0,0
Puducherry,2008,Victims of Other Rape,0,1,3,3,1,0,8
Puducherry,2009,Victims of Incest Rape,0,0,0,0,0,0,0
Puducherry,2009,Victims of Other Rape,0,0,1,0,0,0,1
Puducherry,2010,Victims of Incest Rape,0,0,0,0,0,0,0
Puducherry,2010,Victims of Other Rape,0,0,3,0,0,0,3
Punjab,2001,Victims of Incest Rape,0,0,0,0,0,0,0
Punjab,2001,Victims of Other Rape,1,30,137,98,24,8,298
Punjab,2002,Victims of Incest Rape,0,0,2,2,0,0,4
Punjab,2002,Victims of Other Rape,1,12,30,211,33,8,295
Punjab,2003,Victims of Incest Rape,0,2,2,5,0,0,9
Punjab,2003,Victims of Other Rape,1,12,32,257,63,6,371
Punjab,2004,Victims of Incest Rape,0,2,6,45,12,0,65
Punjab,2004,Victims of Other Rape,0,10,29,217,62,7,325
Punjab,2005,Victims of Incest Rape,0,1,11,25,11,2,50
Punjab,2005,Victims of Other Rape,0,18,12,214,97,7,348
Punjab,2006,Victims of Incest Rape,0,0,0,1,0,0,1
Punjab,2006,Victims of Other Rape,0,19,26,318,64,14,441
Punjab,2007,Victims of Incest Rape,0,0,6,1,0,0,7
Punjab,2007,Victims of Other Rape,3,38,65,301,79,26,512
Punjab,2008,Victims of Incest Rape,0,0,0,1,1,0,2
Punjab,2008,Victims of Other Rape,5,36,45,358,46,27,517
Punjab,2009,Victims of Incest Rape,0,2,3,3,0,0,8
Punjab,2009,Victims of Other Rape,1,46,128,255,43,34,507
Punjab,2010,Victims of Incest Rape,0,4,7,5,0,1,17
Punjab,2010,Victims of Other Rape,1,35,76,341,55,22,530
Rajasthan,2001,Victims of Incest Rape,0,1,7,8,1,1,18
Rajasthan,2001,Victims of Other Rape,7,43,222,598,146,15,1031
Rajasthan,2002,Victims of Incest Rape,1,3,9,13,5,0,31
Rajasthan,2002,Victims of Other Rape,4,5,16,775,215,5,1020
Rajasthan,2003,Victims of Incest Rape,0,0,2,24,5,1,32
Rajasthan,2003,Victims of Other Rape,7,11,29,727,238,6,1018
Rajasthan,2004,Victims of Incest Rape,0,6,7,17,9,0,39
Rajasthan,2004,Victims of Other Rape,7,35,79,628,240,10,999
Rajasthan,2005,Victims of Incest Rape,0,5,10,11,7,0,33
Rajasthan,2005,Victims of Other Rape,16,39,171,504,209,21,960
Rajasthan,2006,Victims of Incest Rape,0,3,12,22,4,1,42
Rajasthan,2006,Victims of Other Rape,5,77,185,533,210,33,1043
Rajasthan,2007,Victims of Incest Rape,1,7,13,15,3,3,42
Rajasthan,2007,Victims of Other Rape,7,72,273,624,184,38,1198
Rajasthan,2008,Victims of Incest Rape,0,6,7,21,4,2,40
Rajasthan,2008,Victims of Other Rape,10,110,268,685,215,27,1315
Rajasthan,2009,Victims of Incest Rape,0,3,7,20,4,2,36
Rajasthan,2009,Victims of Other Rape,4,52,281,836,285,26,1484
Rajasthan,2010,Victims of Incest Rape,0,2,6,10,4,2,24
Rajasthan,2010,Victims of Other Rape,36,70,271,795,342,35,1549
Sikkim,2001,Victims of Incest Rape,0,0,0,0,0,1,1
Sikkim,2001,Victims of Other Rape,0,0,4,2,1,0,7
Sikkim,2002,Victims of Incest Rape,0,1,0,0,0,0,1
Sikkim,2002,Victims of Other Rape,0,1,2,2,0,0,5
Sikkim,2003,Victims of Incest Rape,0,0,0,0,0,0,0
Sikkim,2003,Victims of Other Rape,0,4,1,1,0,4,10
Sikkim,2004,Victims of Incest Rape,0,0,0,0,0,0,0
Sikkim,2004,Victims of Other Rape,0,1,1,0,2,0,4
Sikkim,2005,Victims of Incest Rape,0,1,0,0,0,0,1
Sikkim,2005,Victims of Other Rape,0,4,7,2,2,4,19
Sikkim,2006,Victims of Incest Rape,0,0,0,0,0,0,0
Sikkim,2006,Victims of Other Rape,0,4,5,3,0,8,20
Sikkim,2007,Victims of Incest Rape,0,0,1,0,0,3,4
Sikkim,2007,Victims of Other Rape,0,3,4,5,1,7,20
Sikkim,2008,Victims of Incest Rape,0,0,0,0,0,1,1
Sikkim,2008,Victims of Other Rape,0,3,1,8,0,8,20
Sikkim,2009,Victims of Incest Rape,0,0,0,0,0,0,0
Sikkim,2009,Victims of Other Rape,0,5,5,2,2,4,18
Sikkim,2010,Victims of Incest Rape,0,1,0,0,0,1,2
Sikkim,2010,Victims of Other Rape,0,6,2,1,2,5,16
Tamil Nadu,2001,Victims of Incest Rape,0,2,4,13,2,0,21
Tamil Nadu,2001,Victims of Other Rape,2,13,170,179,32,6,402
Tamil Nadu,2002,Victims of Incest Rape,0,0,0,0,0,0,0
Tamil Nadu,2002,Victims of Other Rape,1,8,6,465,39,15,534
Tamil Nadu,2003,Victims of Incest Rape,0,7,17,12,1,3,40
Tamil Nadu,2003,Victims of Other Rape,1,7,4,348,148,9,517
Tamil Nadu,2004,Victims of Incest Rape,0,0,7,29,0,0,36
Tamil Nadu,2004,Victims of Other Rape,3,50,78,388,30,34,583
Tamil Nadu,2005,Victims of Incest Rape,0,0,0,8,2,1,11
Tamil Nadu,2005,Victims of Other Rape,0,28,58,388,58,28,560
Tamil Nadu,2006,Victims of Incest Rape,0,1,0,0,0,0,1
Tamil Nadu,2006,Victims of Other Rape,2,33,68,275,55,23,456
Tamil Nadu,2007,Victims of Incest Rape,0,0,1,0,0,1,2
Tamil Nadu,2007,Victims of Other Rape,1,41,88,346,35,19,530
Tamil Nadu,2008,Victims of Incest Rape,0,0,0,0,0,1,1
Tamil Nadu,2008,Victims of Other Rape,0,29,131,340,46,26,572
Tamil Nadu,2009,Victims of Incest Rape,0,0,3,0,0,1,4
Tamil Nadu,2009,Victims of Other Rape,2,34,117,390,22,27,592
Tamil Nadu,2010,Victims of Incest Rape,0,0,0,0,0,0,0
Tamil Nadu,2010,Victims of Other Rape,0,50,139,411,66,21,687
Tripura,2001,Victims of Incest Rape,0,0,0,0,0,0,0
Tripura,2001,Victims of Other Rape,0,0,50,47,5,0,102
Tripura,2002,Victims of Incest Rape,0,0,0,0,0,0,0
Tripura,2002,Victims of Other Rape,0,0,0,98,10,0,108
Tripura,2003,Victims of Incest Rape,0,0,0,0,0,0,0
Tripura,2003,Victims of Other Rape,0,0,0,102,12,0,114
Tripura,2004,Victims of Incest Rape,0,0,1,0,0,0,1
Tripura,2004,Victims of Other Rape,0,7,13,109,23,7,159
Tripura,2005,Victims of Incest Rape,0,0,0,0,0,0,0
Tripura,2005,Victims of Other Rape,0,13,4,129,13,3,162
Tripura,2006,Victims of Incest Rape,0,0,4,0,0,0,4
Tripura,2006,Victims of Other Rape,1,4,30,135,17,0,187
Tripura,2007,Victims of Incest Rape,0,0,0,0,0,0,0
Tripura,2007,Victims of Other Rape,0,14,16,113,11,3,157
Tripura,2008,Victims of Incest Rape,0,0,0,0,0,0,0
Tripura,2008,Victims of Other Rape,0,23,65,96,4,16,204
Tripura,2009,Victims of Incest Rape,0,0,0,0,0,0,0
Tripura,2009,Victims of Other Rape,0,22,51,79,28,10,190
Tripura,2010,Victims of Incest Rape,0,0,0,0,0,0,0
Tripura,2010,Victims of Other Rape,0,27,61,93,38,19,238
Uttar Pradesh,2001,Victims of Incest Rape,0,2,0,1,0,0,3
Uttar Pradesh,2001,Victims of Other Rape,0,120,406,1081,314,34,1955
Uttar Pradesh,2002,Victims of Incest Rape,0,1,2,8,0,1,12
Uttar Pradesh,2002,Victims of Other Rape,0,110,269,767,220,37,1403
Uttar Pradesh,2003,Victims of Incest Rape,0,2,5,2,0,1,10
Uttar Pradesh,2003,Victims of Other Rape,2,73,202,475,117,32,901
Uttar Pradesh,2004,Victims of Incest Rape,0,2,21,9,3,0,35
Uttar Pradesh,2004,Victims of Other Rape,2,97,221,829,160,53,1362
Uttar Pradesh,2005,Victims of Incest Rape,0,0,18,52,0,0,70
Uttar Pradesh,2005,Victims of Other Rape,5,103,229,604,162,44,1147
Uttar Pradesh,2006,Victims of Incest Rape,0,0,0,0,0,0,0
Uttar Pradesh,2006,Victims of Other Rape,3,56,273,780,184,18,1314
Uttar Pradesh,2007,Victims of Incest Rape,0,0,0,0,0,1,1
Uttar Pradesh,2007,Victims of Other Rape,0,109,349,910,267,12,1647
Uttar Pradesh,2008,Victims of Incest Rape,0,0,0,0,1,0,1
Uttar Pradesh,2008,Victims of Other Rape,0,171,685,785,185,44,1870
Uttar Pradesh,2009,Victims of Incest Rape,0,0,1,0,0,1,2
Uttar Pradesh,2009,Victims of Other Rape,0,416,165,911,223,42,1757
Uttar Pradesh,2010,Victims of Incest Rape,0,1,2,1,0,0,4
Uttar Pradesh,2010,Victims of Other Rape,0,161,244,861,250,43,1559
Uttarakhand,2001,Victims of Incest Rape,0,0,0,0,0,0,0
Uttarakhand,2001,Victims of Other Rape,0,7,16,38,7,6,74
Uttarakhand,2002,Victims of Incest Rape,0,4,2,6,2,2,16
Uttarakhand,2002,Victims of Other Rape,0,0,0,60,13,0,73
Uttarakhand,2003,Victims of Incest Rape,0,0,0,2,0,0,2
Uttarakhand,2003,Victims of Other Rape,0,4,6,81,13,1,105
Uttarakhand,2004,Victims of Incest Rape,0,0,1,8,4,0,13
Uttarakhand,2004,Victims of Other Rape,0,6,8,64,22,2,102
Uttarakhand,2005,Victims of Incest Rape,0,0,0,2,1,0,3
Uttarakhand,2005,Victims of Other Rape,0,3,12,93,19,3,130
Uttarakhand,2006,Victims of Incest Rape,0,3,0,2,1,0,6
Uttarakhand,2006,Victims of Other Rape,0,4,15,104,17,1,141
Uttarakhand,2007,Victims of Incest Rape,0,2,4,2,0,0,8
Uttarakhand,2007,Victims of Other Rape,0,7,3,72,26,1,109
Uttarakhand,2008,Victims of Incest Rape,0,2,1,2,1,0,6
Uttarakhand,2008,Victims of Other Rape,0,2,4,62,13,0,81
Uttarakhand,2009,Victims of Incest Rape,0,3,1,2,0,0,6
Uttarakhand,2009,Victims of Other Rape,0,0,2,87,15,1,105
Uttarakhand,2010,Victims of Incest Rape,0,2,2,5,1,1,11
Uttarakhand,2010,Victims of Other Rape,0,1,3,87,18,1,110
West Bengal,2001,Victims of Incest Rape,0,0,0,0,0,0,0
West Bengal,2001,Victims of Other Rape,0,3,5,594,103,4,709
West Bengal,2002,Victims of Incest Rape,0,0,0,0,0,0,0
West Bengal,2002,Victims of Other Rape,0,3,8,552,191,5,759
West Bengal,2003,Victims of Incest Rape,0,2,0,12,0,1,15
West Bengal,2003,Victims of Other Rape,2,5,4,814,158,4,987
West Bengal,2004,Victims of Incest Rape,0,0,0,17,7,0,24
West Bengal,2004,Victims of Other Rape,1,3,14,948,483,2,1451
West Bengal,2005,Victims of Incest Rape,0,0,0,31,5,0,36
West Bengal,2005,Victims of Other Rape,1,0,3,1420,223,3,1650
West Bengal,2006,Victims of Incest Rape,0,0,0,6,0,0,6
West Bengal,2006,Victims of Other Rape,0,5,13,1471,234,2,1725
West Bengal,2007,Victims of Incest Rape,0,2,3,81,25,3,114
West Bengal,2007,Victims of Other Rape,5,40,33,1397,506,11,1992
West Bengal,2008,Victims of Incest Rape,0,2,1,1,0,5,9
West Bengal,2008,Victims of Other Rape,1,51,53,1628,504,17,2254
West Bengal,2009,Victims of Incest Rape,0,0,1,1,1,0,3
West Bengal,2009,Victims of Other Rape,0,18,84,1834,391,6,2333
West Bengal,2010,Victims of Incest Rape,0,1,0,2,1,0,4
West Bengal,2010,Victims of Other Rape,0,21,51,1777,458,0,2307
